20 x 20
^^^^^^^^^^^^^^^^^^^^
^^^^^^^^^^^^^^^^^^^^
^^^^^^^^^^^^^^^^^^^^
^^^^^^^^^^_____RRRRR
^^^^^^^^^^_____RRRRR
^^^^^^^^^^_____RRRRR
_______________`````
~~~~~__________`````
~~~~~_______________
~~~~~~~~~~_____#####
~~~~~~~~~~_____###__
~~~~~~~~~~_____##___
~~~~~~~~~~_____##___
~~~~~__________##___
~~~~~_____#######___
^^^^^_____##########
^^^^^_______________
^^^^^_______________
^^^^^^^^^^^^^^^^^^^^
^^^^^^^^^^^^^^^^^^^^
